WE               ./textures/mossy.xpm
NO ./textures/eagle.xpm      
SO ./textures/red_brick.xpm
F 69, 222, 174
EA ./textures/mossy.xpm
C 255, 198, 74

111111111111111111111111
100000000000000000000001
100000000000000000000001
100000000000000000000001
100000000000000000000001
100000000000000000000001
100000000000000000000001
100000111110000101010001
100000100010000000000001
100000100010000100010001
100000100010N00000000001
100000111100000010100001
100000000000000000000001
100000000000000000000001
100000000000000000000001
100000000000000000000001
100000000000000000000001
100000000000000000000001
100000000000000000000001
111111111000000000000001
100100001000000000000001
100000101000000000000001
100100001000000000000001
100111111000000000000001
100000000000000000000001
100000000000000000000001
111111111111111111111111