WE        			./textures/mossy.xpm
NO ./textures/eagle.xpm
SO ./textures/red_brick.xpm
F 190, 150, 110 
C 70,		 190,				 255
EA ./textures/mossy.xpm

111111111111111111111111
100000000000000000000001
100000000000000000000001
100000000000000000000001
100000000000000000000001
100000000000000000000001
100000000000000000000001
100000111110000101010001
100000100010000000000001
100000100000000000010001
100000100000W00000000001
100000111100000000100001
100000000000000000000001
100000000000000000100001
100000000000000000000001
100000000000000000000001
100000000000000000000001
100000000000000010000001
100000000000000010000001
111111111000000000000001
100100001000000000000001
100000101000000000000001
100100001000000000001001
100111111000000000001001
100000000000000000001001
100000000000000000000001
111111111111111111111111