WE ./textures/mossy.xpm
NO ./textures/purplestone.xpm
SO ./textures/red_brick.xpm
EA ./textures/bluestone.xpm

     
F 190, 150, 110
C 70,	 190,				 255 


111111111111111111111111
1000000000000000000000N1
100000000000000000000001
100000000000000000000001
100000000000000000000001
100000000000000000000001
100000000000000000000001
100000111110000101010001
100000100010000000000001
100000100010000000010001
100000100010000000000001
100000111100000000100001
100000000000000000000001
100000000000000000100001
1000000000000111000000001
10000000000001 1000000001
100000000000011100000001
100000000000000010000001
100000000000000010000001
111111111000000000000001
100100001000000000000001
100000101000000000000001
100100001000000000001001
100111111000000000001001
100000000000000000001001
100000000000000000000001
111111111111111111111111
    1101
      101 
     1111