WE ./textures/cobblestone.xpm
NO ./textures/amour.xpm
SO ./textures/bois1.xpm
EA ./textures/stoneblock.xpm

	 
F 80, 167, 88
C 51,	 204,				 255 


111111111111111111111111
100000000000000000000001
100000000000000000000001
100000000000000000000001
100000000000000000000001
100000000000000000000001
100000000000000N00000001
100000111110000101010001
100000100010000000000001
100000100010000000010001
100000100010000000000001
100000111100000000100001
100000000000000000000001
100000000000000000100001
1000000000000111000000001
10000000000001 1000000001
10000000000001 1000000011
100000000000001010000001
100000000000000010000001
111111111000000000000001
100100001000000000000001
100000101000000000000001
100100001000000000001001
100111111000000000001001
100000000000000000001001
100000000000000000000001
111111111111111111111111
    1101
     101 
1111111
1001
111